11111111111111111111111111111111111
10000000000111100000000000000001111
100P0000000000000001111110000000111
10000000011111000000001111000C00011
11111111111111110011000001111111111
10000000000000000011000000000000001
100011000111111111000C0000100000001
10001100011000000000111111100000001
1000C1000110000000000000000000000C1
11111100011100011111000000001111111
10000000111000000111000001111111111
11C11111100000000110001111111111111
11110000000000001100000000000000001
10000000001111111000000100000E00001
11111111111111111111111111111111111