11111
1P001
10011
1E0C1
10001
11111