11111111111111111111111111111111111
10000000000000000000000000000000001
100P0000000000000000000000000000001
10000000010001000000000000000C00001
10000000000111100000000000000000001
10000000000000000000000000000000001
100000000000000000000C0000000000001
10000000000000000000000000000000001
1000C000000000000000000000000000001
10000000000000011000000000000000001
10000000000000000000000000000000001
10000000000000000000000000000000001
100000000000000000000000000E0000001
10000000000000000000000000000000001
11111111111111111111111111111111111