11111
1P001
10011
11001
111C1
100E1
11111