11111111
1000P001
11111101
100C0001
10011111
10000001
11111001
1C0E0001
11111111